#######.#######
#######.p,h,#c#
#l,hhhh,#.#.#.#
##.p#####.#.#.#
#t.#,h,#,,#.p.#
##.#.#.#.##.#.#
##.#.#.#.##.#.#
##.#.#.#.##.#.#
##,h,#,h,##,h,#
###############