#######.#######
#######.p######
#l#p#p#.#######
##,hhhh,p######
#t.#p#p########
##.############
##.p###l#######
##.#l##########
##,hhhhhhc#####
###############
#l#############
#l#############
#l#############
#l#############
#l#############