#######.p#
#l#p#p#.##
##,hhhh,p#
#t.#p#p###
##.#######
##.p###l##
##.#l#####
##.#p#p#p#
##,hhhhhhc
#l########