#######.#######
##,hhhh,p,h,#c#
#l.######.#.#.#
##.p#####.#.#.#
#t.#,hh,#,#.p.#
##.#.##.#.#.#.#
##.#.##.#.#.#.#
##.#.##.#.#.#.#
##,h,##,h,#,h,#
###############