#######.g#
#l#g#g#.##
##,hhhh,g#
##.#g#g###
##.#######
##.g###l##
##.#l#####
##.#g#g#g#
##,hhhhhhc
#l########