#######.#######
#######.p######
#l#p#p#.#######
##,hhhh,p######
#t.#p#p########
##.############
#p.############
##.#p#p#p######
##,hhhhhhc#####
###############
#l#############
#l#############
#l#############
#l#############
#l#############