#######.#######
#######.p,h,#c#
#l,hhhh,#.#.#.#
##.######.#.#.#
#t.#,h,#,,#.#.#
##.#.#.#.##.#.#
##.#.#.#.##.#.#
##.#.#.#.##.#.#
##,h,#,h,##,h,#
###############
