#######.g#
###g#g#.##
##......g#
##.#g#g###
##.#######
##.g######
##.#######
##.#g#g#g#
##.......c
##########